SO img/greystone.xpm
WE img/bluestone.xpm
EA img/eagle.xpm
NO img/wood.xpm

F 255,255,0
C 105,105,105

1111111111111111
1000100000000001
1000000000000001
110000000N000001
1100000000011111
1111111111111111
