SO img/greystone.xpm
WE img/bluestone.xpm
EA img/eagle.xpm
NO img/wood.xpm

F 255,255,0
C 105,105,105

111111111111111111111111111111111
1N0010000000000111000000000111
1000000000000001 10000000000111
1100000000000001110000001111111
110000000001111111111111111111
11111111111
